"filename", "language", "C++", "ROS Message", "XML", "comment", "blank", "total"
"/home/ljj/Nav_USV_ws/src/nav_core/include/nav_core/EKFImuGnss.hpp", "C++", 36, 0, 0, 0, 9, 45
"/home/ljj/Nav_USV_ws/src/nav_core/include/nav_core/EKF_types.hpp", "C++", 67, 0, 0, 0, 17, 84
"/home/ljj/Nav_USV_ws/src/nav_core/include/nav_core/ImuGpsReceive.hpp", "C++", 39, 0, 0, 0, 10, 49
"/home/ljj/Nav_USV_ws/src/nav_core/include/nav_core/InsMech.hpp", "C++", 41, 0, 0, 3, 13, 57
"/home/ljj/Nav_USV_ws/src/nav_core/include/nav_core/NavUSVcontrol.hpp", "C++", 14, 0, 0, 0, 5, 19
"/home/ljj/Nav_USV_ws/src/nav_core/include/nav_core/SbusSimulate.hpp", "C++", 45, 0, 0, 0, 8, 53
"/home/ljj/Nav_USV_ws/src/nav_core/include/nav_core/earth.hpp", "C++", 108, 0, 0, 10, 34, 152
"/home/ljj/Nav_USV_ws/src/nav_core/msg/sbus_channels_msg.msg", "ROS Message", 0, 2, 0, 0, 0, 2
"/home/ljj/Nav_USV_ws/src/nav_core/node/ImuGpsReceiveNode.cpp", "C++", 7, 0, 0, 0, 1, 8
"/home/ljj/Nav_USV_ws/src/nav_core/node/NavUSVcontrolNode.cpp", "C++", 7, 0, 0, 0, 1, 8
"/home/ljj/Nav_USV_ws/src/nav_core/node/SbusSimulateOutputNode.cpp", "C++", 8, 0, 0, 0, 2, 10
"/home/ljj/Nav_USV_ws/src/nav_core/package.xml", "XML", 0, 0, 25, 0, 3, 28
"/home/ljj/Nav_USV_ws/src/nav_core/src/EKFImuGnss.cpp", "C++", 132, 0, 0, 10, 53, 195
"/home/ljj/Nav_USV_ws/src/nav_core/src/ImuGpsReceive.cpp", "C++", 181, 0, 0, 46, 24, 251
"/home/ljj/Nav_USV_ws/src/nav_core/src/NavUSVcontrol.cpp", "C++", 16, 0, 0, 0, 5, 21
"/home/ljj/Nav_USV_ws/src/nav_core/src/SbusSimulate.cpp", "C++", 64, 0, 0, 28, 11, 103
"Total", "-", 765, 2, 25, 97, 196, 1085