"filename", "language", "C++", "YAML", "comment", "blank", "total"
"/home/ljj/Nav_USV_ws/src/nav_core/include/kf_gins/EKFImuGnss.hpp", "C++", 45, 0, 0, 12, 57
"/home/ljj/Nav_USV_ws/src/nav_core/include/kf_gins/EKF_types.hpp", "C++", 67, 0, 0, 20, 87
"/home/ljj/Nav_USV_ws/src/nav_core/include/kf_gins/InitialAlignment.hpp", "C++", 0, 0, 0, 1, 1
"/home/ljj/Nav_USV_ws/src/nav_core/include/kf_gins/InsMech.hpp", "C++", 45, 0, 0, 13, 58
"/home/ljj/Nav_USV_ws/src/nav_core/include/kf_gins/Rotation.hpp", "C++", 78, 0, 3, 19, 100
"/home/ljj/Nav_USV_ws/src/nav_core/include/kf_gins/earth.hpp", "C++", 108, 0, 10, 34, 152
"/home/ljj/Nav_USV_ws/src/nav_core/include/nav_core/EKFImuGnss.hpp", "C++", -36, 0, 0, -9, -45
"/home/ljj/Nav_USV_ws/src/nav_core/include/nav_core/EKF_types.hpp", "C++", -67, 0, 0, -17, -84
"/home/ljj/Nav_USV_ws/src/nav_core/include/nav_core/InsMech.hpp", "C++", -41, 0, -3, -13, -57
"/home/ljj/Nav_USV_ws/src/nav_core/include/nav_core/earth.hpp", "C++", -108, 0, -10, -34, -152
"/home/ljj/Nav_USV_ws/src/nav_core/node/EKFNavUpdateNode.cpp", "C++", 81, 0, 14, 17, 112
"/home/ljj/Nav_USV_ws/src/nav_core/params/kf-gins.yaml", "YAML", 0, 21, 0, 7, 28
"/home/ljj/Nav_USV_ws/src/nav_core/src/EKFImuGnss.cpp", "C++", 43, 0, -7, 16, 52
"/home/ljj/Nav_USV_ws/src/nav_core/src/InitialAlignment.cpp", "C++", 0, 0, 0, 1, 1
"Total", "-", 215, 21, 7, 67, 310