"filename", "language", "ROS Message", "C++", "XML", "YAML", "comment", "blank", "total"
"/home/ljj/Nav_USV_ws/src/nav_core/include/kf_gins/EKFImuGnss.hpp", "C++", 0, 70, 0, 0, 0, 16, 86
"/home/ljj/Nav_USV_ws/src/nav_core/include/kf_gins/EKF_types.hpp", "C++", 0, 67, 0, 0, 0, 20, 87
"/home/ljj/Nav_USV_ws/src/nav_core/include/kf_gins/InsMech.hpp", "C++", 0, 45, 0, 0, 0, 13, 58
"/home/ljj/Nav_USV_ws/src/nav_core/include/kf_gins/Rotation.hpp", "C++", 0, 78, 0, 0, 3, 19, 100
"/home/ljj/Nav_USV_ws/src/nav_core/include/kf_gins/earth.hpp", "C++", 0, 108, 0, 0, 10, 34, 152
"/home/ljj/Nav_USV_ws/src/nav_core/include/nav_core/ImuGpsReceive.hpp", "C++", 0, 39, 0, 0, 0, 10, 49
"/home/ljj/Nav_USV_ws/src/nav_core/include/nav_core/NavUSVcontrol.hpp", "C++", 0, 14, 0, 0, 0, 5, 19
"/home/ljj/Nav_USV_ws/src/nav_core/include/nav_core/SbusSimulate.hpp", "C++", 0, 45, 0, 0, 0, 8, 53
"/home/ljj/Nav_USV_ws/src/nav_core/msg/sbus_channels_msg.msg", "ROS Message", 2, 0, 0, 0, 0, 0, 2
"/home/ljj/Nav_USV_ws/src/nav_core/node/EKFNavUpdateNode.cpp", "C++", 0, 81, 0, 0, 14, 16, 111
"/home/ljj/Nav_USV_ws/src/nav_core/node/ImuGpsReceiveNode.cpp", "C++", 0, 7, 0, 0, 0, 1, 8
"/home/ljj/Nav_USV_ws/src/nav_core/node/NavUSVcontrolNode.cpp", "C++", 0, 7, 0, 0, 0, 1, 8
"/home/ljj/Nav_USV_ws/src/nav_core/node/SbusSimulateOutputNode.cpp", "C++", 0, 8, 0, 0, 0, 2, 10
"/home/ljj/Nav_USV_ws/src/nav_core/package.xml", "XML", 0, 0, 25, 0, 0, 3, 28
"/home/ljj/Nav_USV_ws/src/nav_core/params/kf-gins.yaml", "YAML", 0, 0, 0, 21, 0, 7, 28
"/home/ljj/Nav_USV_ws/src/nav_core/src/EKFImuGnss.cpp", "C++", 0, 249, 0, 0, 4, 97, 350
"/home/ljj/Nav_USV_ws/src/nav_core/src/ImuGpsReceive.cpp", "C++", 0, 181, 0, 0, 46, 23, 250
"/home/ljj/Nav_USV_ws/src/nav_core/src/NavUSVcontrol.cpp", "C++", 0, 16, 0, 0, 0, 5, 21
"/home/ljj/Nav_USV_ws/src/nav_core/src/SbusSimulate.cpp", "C++", 0, 64, 0, 0, 28, 11, 103
"Total", "-", 2, 1079, 25, 21, 105, 291, 1523